{
tiles: [
	[ 5, 5, 5, 5, 5, 5, 5, 5, 5 ]
	[ 0, 1, 1, 1, 1, 1, 1, 1, 0 ]
	[ 0, 1, 1, 1, 1, 1, 1, 1, 0 ]
	[ 5, 2, 2, 2, 8, 2, 2, 2, 5 ]
	[ 0, 0, 0, 0, 0, 0, 0, 0, 0 ]
	[ 5, 2, 2, 2, 8, 2, 2, 2, 5 ]
	[ 0, 1, 1, 1, 1, 1, 1, 1, 0 ]
	[ 0, 1, 1, 1, 1, 1, 1, 1, 0 ]
	[ 5, 5, 5, 5, 5, 5, 5, 5, 5 ]
]
targetScore: 1000
moves: 5
explosions: 12
isBird: false
isSideways: false
}