{
tiles: [
	[ 2, 2, 2, 0, 0, 0, 2, 2, 2 ]
	[ 1, 1, 1, 1, 1, 1, 1, 1, 1 ]
	[ 1, 1, 1, 1, 1, 1, 1, 1, 1 ]
	[ 1, 1, 1, 1, 1, 1, 1, 1, 1 ]
	[ 0, 0, 3, 0, 3, 0, 3, 0, 0 ]
	[ 1, 1, 1, 1, 1, 1, 1, 1, 1 ]
	[ 1, 1, 1, 1, 1, 1, 1, 1, 1 ]
	[ 1, 1, 1, 1, 1, 1, 1, 1, 1 ]
	[ 2, 2, 2, 0, 0, 0, 2, 2, 2 ]
]
targetScore: 1500
moves: 10
explosions: 3
}