{
tiles: [
	[ 0, 0, 0, 0, 0, 0, 0, 0, 0 ]
	[ 0, 0, 0, 0, 0, 0, 0, 0, 0 ]
	[ 2, 1, 2, 0, 2, 1, 2, 0, 2 ]
	[ 2, 1, 2, 1, 2, 1, 2, 1, 2 ]
	[ 2, 1, 2, 1, 2, 1, 2, 1, 2 ]
	[ 2, 1, 2, 1, 2, 1, 2, 1, 2 ]
	[ 2, 0, 2, 1, 2, 0, 2, 1, 2 ]
	[ 0, 0, 0, 0, 0, 0, 0, 0, 0 ]
	[ 0, 0, 0, 0, 0, 0, 0, 0, 0 ]
]
targetScore: 1000
moves: 10
explosions: 3
}