{
tiles: [
	[ 0, 1, 1, 1, 1, 1, 1, 1, 0 ]
	[ 0, 1, 1, 1, 1, 1, 1, 1, 0 ]
	[ 8, 2, 2, 2, 2, 2, 2, 2, 8 ]
	[ 0, 1, 1, 1, 1, 1, 1, 1, 0 ]
	[ 0, 0, 0, 0, 0, 0, 0, 0, 0 ]
	[ 0, 1, 1, 1, 1, 1, 1, 1, 0 ]
	[ 8, 2, 2, 2, 2, 2, 2, 2, 8 ]
	[ 0, 1, 1, 1, 1, 1, 1, 1, 0 ]
	[ 0, 1, 1, 1, 1, 1, 1, 1, 0 ]
]
targetScore: 500
moves: 4
explosions: 12
isBird: true
isSideways: false
}