{
tiles: [
	[ 0, 0, 0, 0, 0, 0, 0, 0, 0 ]
	[ 0, 1, 1, 1, 1, 1, 1, 1, 0 ]
	[ 0, 1, 5, 2, 2, 2, 5, 1, 0 ]
	[ 0, 1, 2, 2, 2, 2, 2, 1, 0 ]
	[ 0, 1, 2, 2, 0, 2, 2, 1, 0 ]
	[ 0, 1, 2, 2, 2, 2, 2, 1, 0 ]
	[ 0, 1, 5, 2, 2, 2, 5, 1, 0 ]
	[ 0, 1, 1, 1, 1, 1, 1, 1, 0 ]
	[ 0, 0, 0, 0, 0, 0, 0, 0, 0 ]
]
targetScore: 1000
moves: 10
explosions: 3
isBird: false
isSideways: false
}