{
tiles: [
	[ 0, 0, 0, 5, 5, 5, 0, 0, 0 ]
	[ 0, 1, 1, 1, 1, 1, 1, 1, 0 ]
	[ 0, 1, 1, 1, 1, 1, 1, 1, 0 ]
	[ 0, 1, 1, 1, 0, 1, 1, 1, 0 ]
	[ 8, 1, 1, 0, 0, 0, 1, 1, 8 ]
	[ 0, 1, 1, 1, 0, 1, 1, 1, 0 ]
	[ 0, 1, 1, 1, 1, 1, 1, 1, 0 ]
	[ 0, 1, 1, 1, 1, 1, 1, 1, 0 ]
	[ 0, 0, 0, 5, 5, 5, 0, 0, 0 ]
]
targetScore: 1600
moves: 12
explosions: 5
isBird: false
isSideways: false
}