{
tiles: [
	[ 2, 1, 1, 1, 1, 1, 1, 1, 1 ]
	[ 2, 0, 1, 1, 1, 1, 1, 1, 1 ]
	[ 2, 1, 1, 1, 1, 1, 1, 1, 1 ]
	[ 2, 0, 1, 1, 1, 1, 1, 1, 1 ]
	[ 3, 0, 0, 0, 0, 0, 0, 0, 0 ]
	[ 2, 0, 1, 1, 1, 1, 1, 1, 1 ]
	[ 2, 1, 1, 1, 1, 1, 1, 1, 1 ]
	[ 2, 0, 1, 1, 1, 1, 1, 1, 1 ]
	[ 2, 1, 1, 1, 1, 1, 1, 1, 1 ]
]
targetScore: 1200
moves: 10
explosions: 3
}