{
tiles: [
	[ 0, 0, 0, 0, 0, 0, 0, 0, 0 ]
	[ 0, 1, 1, 1, 1, 1, 1, 1, 0 ]
	[ 0, 1, 1, 1, 1, 1, 1, 1, 0 ]
	[ 5, 1, 1, 1, 1, 1, 1, 1, 5 ]
	[ 8, 5, 1, 1, 0, 1, 1, 5, 8 ]
	[ 5, 1, 1, 1, 1, 1, 1, 1, 5 ]
	[ 0, 1, 1, 1, 1, 1, 1, 1, 0 ]
	[ 0, 1, 1, 1, 1, 1, 1, 1, 0 ]
	[ 0, 0, 0, 0, 0, 0, 0, 0, 0 ]
]
targetScore: 1200
moves: 10
explosions: 5
isBird: false
isSideways: true
}