{
tiles: [
	[ 0, 0, 0, 1, 1, 1, 0, 0, 0 ]
	[ 0, 1, 1, 1, 1, 1, 1, 1, 0 ]
	[ 0, 1, 1, 1, 1, 1, 1, 1, 0 ]
	[ 0, 1, 1, 1, 8, 1, 1, 1, 0 ]
	[ 0, 1, 1, 8, 0, 8, 1, 1, 0 ]
	[ 0, 1, 1, 1, 8, 1, 1, 1, 0 ]
	[ 0, 1, 1, 1, 1, 1, 1, 1, 0 ]
	[ 0, 1, 1, 1, 1, 1, 1, 1, 0 ]
	[ 0, 0, 0, 1, 1, 1, 0, 0, 0 ]
]
targetScore: 1200
moves: 10
explosions: 4
isBird: false
isSideways: false
}