{
tiles: [
	[ 0, 0, 0, 0, 0, 0, 0, 0, 0 ]
	[ 0, 1, 1, 1, 1, 1, 1, 1, 0 ]
	[ 0, 1, 1, 1, 1, 1, 1, 1, 0 ]
	[ 0, 1, 1, 5, 2, 5, 1, 1, 0 ]
	[ 0, 1, 1, 2, 8, 2, 1, 1, 0 ]
	[ 0, 1, 1, 5, 2, 5, 1, 1, 0 ]
	[ 0, 1, 1, 1, 1, 1, 1, 1, 0 ]
	[ 0, 1, 1, 1, 1, 1, 1, 1, 0 ]
	[ 0, 0, 0, 0, 0, 0, 0, 0, 0 ]
]
targetScore: 1000
moves: 10
explosions: 4
isBird: false
isSideways: false
}