{
tiles: [
	[ 0, 0, 0, 2, 2, 2, 0, 0, 0 ]
	[ 0, 1, 1, 1, 1, 1, 1, 1, 0 ]
	[ 0, 1, 1, 1, 1, 1, 1, 1, 0 ]
	[ 0, 1, 1, 1, 0, 1, 1, 1, 0 ]
	[ 8, 1, 1, 0, 0, 0, 1, 1, 8 ]
	[ 0, 1, 1, 1, 0, 1, 1, 1, 0 ]
	[ 0, 1, 1, 1, 1, 1, 1, 1, 0 ]
	[ 0, 1, 1, 1, 1, 1, 1, 1, 0 ]
	[ 0, 0, 0, 2, 2, 2, 0, 0, 0 ]
]
targetScore: 1500
moves: 12
explosions: 4
isBird: false
isSideways: false
}