{
tiles: [
	[ 0, 0, 0, 0, 0, 0, 0, 0, 0 ]
	[ 0, 1, 1, 1, 1, 1, 1, 1, 0 ]
	[ 0, 1, 1, 1, 1, 1, 1, 1, 0 ]
	[ 2, 5, 1, 1, 1, 1, 1, 5, 2 ]
	[ 8, 5, 1, 1, 0, 1, 1, 5, 8 ]
	[ 2, 5, 1, 1, 1, 1, 1, 5, 2 ]
	[ 0, 1, 1, 1, 1, 1, 1, 1, 0 ]
	[ 0, 1, 1, 1, 1, 1, 1, 1, 0 ]
	[ 0, 0, 0, 0, 0, 0, 0, 0, 0 ]
]
targetScore: 1500
moves: 10
explosions: 5
isBird: true
isSideways: false
}