{
tiles: [
	[ 8, 2, 2, 2, 2, 2, 2, 2, 8 ]
	[ 0, 5, 5, 5, 5, 5, 5, 5, 0 ]
	[ 0, 1, 1, 1, 1, 1, 1, 1, 0 ]
	[ 0, 1, 1, 1, 1, 1, 1, 1, 0 ]
	[ 0, 0, 0, 0, 0, 0, 0, 0, 0 ]
	[ 0, 1, 1, 1, 1, 1, 1, 1, 0 ]
	[ 0, 1, 1, 1, 1, 1, 1, 1, 0 ]
	[ 0, 1, 1, 1, 1, 1, 1, 1, 0 ]
	[ 1, 1, 1, 1, 1, 1, 1, 1, 1 ]
]
targetScore: 500
moves: 4
explosions: 10
isBird: true
isSideways: false
}