{
tiles: [
	[ 0, 0, 0, 0, 0, 0, 0, 0, 0 ]
	[ 0, 1, 1, 1, 1, 1, 1, 1, 0 ]
	[ 0, 1, 1, 1, 1, 1, 1, 1, 0 ]
	[ 0, 1, 1, 1, 1, 1, 1, 1, 0 ]
	[ 8, 8, 1, 1, 0, 1, 1, 8, 8 ]
	[ 0, 1, 1, 1, 1, 1, 1, 1, 0 ]
	[ 0, 1, 1, 1, 1, 1, 1, 1, 0 ]
	[ 0, 1, 1, 1, 1, 1, 1, 1, 0 ]
	[ 0, 0, 0, 0, 0, 0, 0, 0, 0 ]
]
targetScore: 1500
moves: 10
explosions: 5
isBird: false
isSideways: true
}