{
tiles: [
	[ 0, 2, 0, 2, 0, 2, 0, 2, 0 ]
	[ 1, 1, 1, 1, 1, 1, 1, 1, 1 ]
	[ 1, 1, 1, 1, 1, 1, 1, 1, 1 ]
	[ 1, 1, 1, 1, 1, 1, 1, 1, 1 ]
	[ 0, 0, 3, 0, 3, 0, 3, 0, 0 ]
	[ 1, 1, 1, 1, 1, 1, 1, 1, 1 ]
	[ 1, 1, 1, 1, 1, 1, 1, 1, 1 ]
	[ 1, 1, 1, 1, 1, 1, 1, 1, 1 ]
	[ 0, 2, 0, 2, 0, 2, 0, 2, 0 ]
]
targetScore: 1200
moves: 10
explosions: 4
}