{
tiles: [
	[ 5, 1, 1, 1, 1, 1, 1, 1, 5 ]
	[ 0, 1, 1, 1, 1, 1, 1, 1, 0 ]
	[ 5, 1, 1, 1, 1, 1, 1, 1, 5 ]
	[ 0, 1, 1, 1, 1, 1, 1, 1, 0 ]
	[ 0, 0, 0, 0, 0, 0, 0, 0, 0 ]
	[ 0, 1, 1, 1, 1, 1, 1, 1, 0 ]
	[ 5, 1, 1, 1, 1, 1, 1, 1, 5 ]
	[ 0, 1, 1, 1, 1, 1, 1, 1, 0 ]
	[ 5, 1, 1, 1, 1, 1, 1, 1, 5 ]
]
targetScore: 500
moves: 4
explosions: 12
isBird: false
isSideways: false
}