{
tiles: [
	[ 1, 1, 1, 1, 1, 1, 1, 1, 1 ]
	[ 2, 0, 2, 0, 2, 0, 2, 0, 2 ]
	[ 2, 1, 2, 0, 2, 1, 2, 0, 2 ]
	[ 2, 1, 2, 1, 2, 1, 2, 1, 2 ]
	[ 2, 1, 2, 1, 2, 1, 2, 1, 2 ]
	[ 2, 1, 2, 1, 2, 1, 2, 1, 2 ]
	[ 2, 0, 2, 1, 2, 1, 2, 0, 2 ]
	[ 2, 0, 2, 0, 2, 0, 2, 0, 2 ]
	[ 1, 1, 1, 1, 1, 1, 1, 1, 1 ]
]
targetScore: 2000
moves: 10
explosions: 4
}