{
tiles: [
	[ 0, 0, 0, 1, 1, 1, 0, 0, 0 ]
	[ 0, 1, 1, 1, 1, 1, 1, 1, 0 ]
	[ 0, 1, 8, 2, 2, 2, 8, 1, 0 ]
	[ 1, 1, 2, 2, 0, 2, 2, 1, 1 ]
	[ 1, 1, 2, 2, 0, 2, 2, 1, 1 ]
	[ 1, 1, 2, 2, 0, 2, 2, 1, 1 ]
	[ 0, 1, 8, 2, 2, 2, 8, 1, 0 ]
	[ 0, 1, 1, 1, 1, 1, 1, 1, 0 ]
	[ 0, 0, 0, 1, 1, 1, 0, 0, 0 ]
]
targetScore: 1000
moves: 10
explosions: 4
isBird: false
isSideways: false
}