{
tiles: [
	[ 0, 0, 0, 0, 0, 0, 0, 0, 0 ]
	[ 0, 0, 0, 0, 0, 0, 0, 0, 0 ]
	[ 3, 1, 3, 0, 3, 1, 3, 0, 3 ]
	[ 3, 1, 3, 1, 3, 1, 3, 1, 3 ]
	[ 3, 1, 3, 1, 3, 1, 3, 1, 3 ]
	[ 3, 1, 3, 1, 3, 1, 3, 1, 3 ]
	[ 3, 0, 3, 1, 3, 0, 3, 1, 3 ]
	[ 0, 0, 0, 0, 0, 0, 0, 0, 0 ]
	[ 0, 0, 0, 0, 0, 0, 0, 0, 0 ]
]
targetScore: 2000
moves: 12
explosions: 4
}