{
tiles: [
	[ 1, 1, 1, 1, 1, 1, 1, 1, 1 ]
	[ 1, 2, 2, 2, 2, 2, 2, 2, 1 ]
	[ 1, 2, 2, 2, 2, 2, 2, 2, 1 ]
	[ 1, 2, 2, 0, 0, 0, 2, 2, 1 ]
	[ 1, 2, 2, 0, 0, 0, 2, 2, 1 ]
	[ 1, 2, 2, 0, 0, 0, 2, 2, 1 ]
	[ 1, 2, 2, 2, 2, 2, 2, 2, 1 ]
	[ 1, 2, 2, 2, 2, 2, 2, 2, 1 ]
	[ 1, 1, 1, 1, 1, 1, 1, 1, 1 ]
]
targetScore: 1500
moves: 10
explosions: 4
isBird: false
isSideways: false
}