{
tiles: [
	[ 0, 1, 1, 1, 1, 1, 1, 1, 0 ]
	[ 0, 1, 1, 1, 1, 1, 1, 1, 0 ]
	[ 0, 1, 1, 1, 1, 1, 1, 1, 0 ]
	[ 5, 5, 5, 5, 5, 5, 5, 5, 5 ]
	[ 0, 0, 0, 0, 0, 0, 0, 0, 0 ]
	[ 5, 5, 5, 5, 5, 5, 5, 5, 5 ]
	[ 0, 1, 1, 1, 1, 1, 1, 1, 0 ]
	[ 0, 1, 1, 1, 1, 1, 1, 1, 0 ]
	[ 0, 1, 1, 1, 1, 1, 1, 1, 0 ]
]
targetScore: 500
moves: 4
explosions: 12
isBird: true
isSideways: false
}