{
tiles: [
	[ 1, 1, 1, 1, 1, 1, 1, 1, 1 ]
	[ 0, 5, 1, 1, 1, 1, 1, 5, 0 ]
	[ 8, 5, 1, 1, 1, 1, 1, 5, 8 ]
	[ 0, 5, 1, 1, 1, 1, 1, 5, 0 ]
	[ 0, 0, 0, 0, 0, 0, 0, 0, 0 ]
	[ 0, 5, 1, 1, 1, 1, 1, 5, 0 ]
	[ 8, 5, 1, 1, 1, 1, 1, 5, 8 ]
	[ 0, 5, 1, 1, 1, 1, 1, 5, 0 ]
	[ 1, 1, 1, 1, 1, 1, 1, 1, 1 ]
]
targetScore: 500
moves: 5
explosions: 12
isBird: true
isSideways: false
}