{
tiles: [
	[ 1, 1, 1, 1, 0, 1, 1, 1, 1 ]
	[ 1, 1, 1, 1, 0, 1, 1, 1, 1 ]
	[ 1, 1, 1, 1, 0, 1, 1, 1, 1 ]
	[ 1, 1, 1, 3, 3, 3, 1, 1, 1 ]
	[ 0, 0, 0, 3, 3, 3, 0, 0, 0 ]
	[ 1, 1, 1, 3, 3, 3, 1, 1, 1 ]
	[ 1, 1, 1, 1, 0, 1, 1, 1, 1 ]
	[ 1, 1, 1, 1, 0, 1, 1, 1, 1 ]
	[ 1, 1, 1, 1, 0, 1, 1, 1, 1 ]
]
targetScore: 1200
moves: 12
explosions: 3
}