{
tiles: [
	[ 0, 0, 1, 1, 1, 1, 1, 0, 0 ]
	[ 0, 0, 1, 0, 3, 0, 1, 0, 0 ]
	[ 2, 1, 2, 0, 3, 1, 2, 0, 2 ]
	[ 2, 1, 2, 1, 3, 1, 2, 1, 2 ]
	[ 2, 1, 2, 1, 3, 1, 2, 1, 2 ]
	[ 2, 1, 2, 1, 3, 1, 2, 1, 2 ]
	[ 2, 0, 2, 1, 3, 0, 2, 1, 2 ]
	[ 0, 0, 1, 0, 3, 0, 1, 0, 0 ]
	[ 0, 0, 1, 1, 1, 1, 1, 0, 0 ]
]
targetScore: 1800
moves: 12
explosions: 4
}