{
tiles: [
	[ 0, 0, 0, 0, 1, 0, 0, 0, 0 ]
	[ 0, 1, 1, 1, 1, 1, 1, 1, 0 ]
	[ 0, 1, 1, 1, 1, 1, 1, 1, 0 ]
	[ 5, 1, 1, 1, 1, 1, 1, 1, 5 ]
	[ 8, 0, 0, 0, 0, 0, 0, 0, 8 ]
	[ 5, 1, 1, 1, 1, 1, 1, 1, 5 ]
	[ 0, 1, 1, 1, 1, 1, 1, 1, 0 ]
	[ 0, 1, 1, 1, 1, 1, 1, 1, 0 ]
	[ 0, 0, 0, 0, 1, 0, 0, 0, 0 ]
]
targetScore: 500
moves: 4
explosions: 10
isBird: false
isSideways: false
}