{
tiles: [
	[ 1, 1, 1, 1, 1, 1, 1, 1, 1 ]
	[ 2, 0, 2, 0, 3, 0, 2, 0, 2 ]
	[ 2, 1, 2, 0, 3, 1, 2, 0, 2 ]
	[ 2, 1, 2, 1, 3, 1, 2, 1, 2 ]
	[ 2, 1, 2, 1, 3, 1, 2, 1, 2 ]
	[ 2, 1, 2, 1, 3, 1, 2, 1, 2 ]
	[ 2, 0, 2, 1, 3, 1, 2, 0, 2 ]
	[ 2, 0, 2, 0, 3, 0, 2, 0, 2 ]
	[ 1, 1, 1, 1, 1, 1, 1, 1, 1 ]
]
targetScore: 2500
moves: 12
explosions: 4
}