{
tiles: [
	[ 1, 1, 1, 1, 1, 1, 1, 1, 1 ]
	[ 1, 1, 1, 1, 0, 1, 1, 1, 1 ]
	[ 1, 1, 1, 1, 0, 1, 1, 1, 1 ]
	[ 0, 3, 3, 3, 3, 3, 3, 3, 0 ]
	[ 0, 0, 0, 0, 0, 0, 0, 0, 0 ]
	[ 0, 3, 3, 3, 3, 3, 3, 3, 0 ]
	[ 1, 1, 1, 1, 0, 1, 1, 1, 1 ]
	[ 1, 1, 1, 1, 0, 1, 1, 1, 1 ]
	[ 1, 1, 1, 1, 1, 1, 1, 1, 1 ]
]
targetScore: 800
moves: 7
explosions: 4
}