{
tiles: [
	[ 1, 1, 1, 1, 1, 1, 1, 1, 1 ]
	[ 1, 1, 1, 1, 1, 1, 1, 1, 1 ]
	[ 2, 0, 2, 0, 2, 0, 2, 0, 2 ]
	[ 2, 0, 2, 0, 2, 0, 2, 0, 2 ]
	[ 2, 2, 2, 2, 2, 2, 2, 2, 2 ]
	[ 2, 0, 2, 0, 2, 0, 2, 0, 2 ]
	[ 2, 0, 2, 0, 2, 0, 2, 0, 2 ]
	[ 1, 1, 1, 1, 1, 1, 1, 1, 1 ]
	[ 1, 1, 1, 1, 1, 1, 1, 1, 1 ]
]
targetScore: 1400
moves: 15
explosions: 3
}