{
tiles: [
	[ 0, 0, 0, 0, 0, 0, 8, 2, 8 ]
	[ 1, 1, 1, 1, 1, 1, 1, 1, 1 ]
	[ 1, 1, 1, 1, 1, 1, 1, 1, 1 ]
	[ 1, 1, 1, 1, 1, 1, 1, 1, 1 ]
	[ 1, 1, 1, 1, 1, 1, 1, 1, 1 ]
	[ 1, 1, 1, 1, 1, 1, 1, 1, 1 ]
	[ 1, 1, 1, 1, 1, 1, 1, 1, 1 ]
	[ 1, 1, 1, 1, 1, 1, 1, 1, 1 ]
	[ 8, 2, 8, 0, 0, 0, 0, 0, 0 ]
]
targetScore: 1500
moves: 10
explosions: 5
isBird: true
isSideways: false
}