{
tiles: [
	[ 1, 1, 1, 1, 0, 1, 1, 1, 1 ]
	[ 1, 1, 1, 1, 0, 1, 1, 1, 1 ]
	[ 1, 1, 1, 1, 0, 1, 1, 1, 1 ]
	[ 0, 2, 2, 2, 2, 2, 2, 2, 0 ]
	[ 0, 0, 0, 0, 2, 0, 0, 0, 0 ]
	[ 0, 2, 2, 2, 2, 2, 2, 2, 0 ]
	[ 1, 1, 1, 1, 0, 1, 1, 1, 1 ]
	[ 1, 1, 1, 1, 0, 1, 1, 1, 1 ]
	[ 1, 1, 1, 1, 0, 1, 1, 1, 1 ]
]
targetScore: 1200
moves: 10
explosions: 3
}