{
tiles: [
	[ 0, 0, 0, 8, 5, 5, 5, 5, 8 ]
	[ 0, 0, 1, 1, 1, 1, 1, 1, 0 ]
	[ 0, 1, 1, 1, 1, 1, 1, 0, 0 ]
	[ 1, 1, 1, 1, 1, 1, 0, 0, 0 ]
	[ 0, 0, 0, 0, 0, 0, 0, 0, 0 ]
	[ 0, 0, 0, 1, 1, 1, 1, 1, 1 ]
	[ 0, 0, 1, 1, 1, 1, 1, 1, 0 ]
	[ 0, 1, 1, 1, 1, 1, 1, 0, 0 ]
	[ 8, 5, 5, 5, 5, 8, 0, 0, 0 ]
]
targetScore: 500
moves: 4
explosions: 12
isBird: false
isSideways: false
}