{
tiles: [
	[ 2, 2, 2, 2, 7, 2, 2, 2, 2 ]
	[ 4, 4, 4, 4, 4, 4, 4, 4, 4 ]
	[ 1, 1, 1, 1, 1, 1, 1, 1, 1 ]
	[ 1, 1, 1, 1, 1, 1, 1, 1, 1 ]
	[ 1, 1, 1, 1, 1, 1, 1, 1, 1 ]
	[ 1, 1, 1, 1, 1, 1, 1, 1, 1 ]
	[ 1, 1, 1, 1, 1, 1, 1, 1, 1 ]
	[ 1, 1, 1, 1, 1, 1, 1, 1, 1 ]
	[ 0, 0, 0, 0, 0, 0, 0, 0, 0 ]
]
targetScore: 500
moves: 4
explosions: 10
isBird: true
isSideways: false
}